┌─────┐                                      ┌─────────┐
│┼┼┼┼┼┼─────────────┐                        │┼┼┼┼┼┼┼┼┼│
│┼┼┼┼┼┼┼┼┼┼┼┼┼┼┼┼┼┼┼┼────────────────────────┼┼┼┼┼┼┼┼┼┼│
│┼┼┼┼┼┼┼┼┼┼┼┼┼┼┼┼┼┼┼┼┼┼┼┼┼┼┼┼┼┼┼┼┼┼┼┼┼┼┼┼┼┼┼┼┼┼┼┼┼┼┼┼┼┼│
│┼┼┼┼┼┼┼┼┼┼┼┼┼┼┼┼┼┼┼┼┼┼┼┼┼┼┼┼┼┼┼┼┼┼┼┼┼┼┼┼┼┼┼┼┼┼┼┼┼┼┼┼┼┼│
│┼┼┼┼┼┼┼┼┼┼┼┼┼┼┼┼┼┼┼┼┼┼┼┼┼┼┼┼┼┼┼┼┼┼┼┼┼┼┼┼┼┼┼┼┼┼┼┼┼┼┼┼┼┼│
└──────────────────────────────────────────────────────┘